R 1280 920
NO ./textures/grass.xpm
SO ./textures/metal.xpm
WE ./textures/grass.xpm
EA ./textures/metal.xpm
S ./textures/disk.xpm
F 141,150,129
C 129,203,214
            1111111111111111111111111
            1000000000110000000000001
            1001100020000200202000N01
            1001100000000000000000001
    111111111001100001110000000000001
    100000000001100001110011111111111
    11110000000111001100000010001
    11110011111111001100000010001
    11000000110101001100110010001
    10002000000000200000000200001
    10000000000000000001000000001
    1100200111010101111100000000111
    11000001 1110101 101111010001
    11111111 1111111 111111111111
